%%%%%%%%%%%%%%%%%%%%
%.           .    .%
%                . %
%                  %
%         G       .%
%                  %
%.                 %
%P               . %
%%%%%%%%%%%%%%%%%%%%
